################################
#..............................#
#.............#..#.............#
#..........#..#..#..#..........#
#..P..........#..#.............#
#..........#..#..#..#..........#
#.............#..#.............#
#..............................#
################################
